====================
S..................=
==================.=
==================.=
==================.=
==================.=
=..............===.=
==.=====.=====.===.=
==.=====.=====.===.=
==.=====.=====.===.=
==.=====.=====.===.=
=..=====...===.....=
=.========.====.====
=.========.====.====
=.========.====.====
=.========.====.====
=.========.====.====
=.========.====....=
=....=====.=======.=
==========E=========
